{
    "maze": [
	      "##############################",
	      ".............................#",
	      "#.#####.##.#####.##.##.##.####",
	      "#.#####.##.#####.##.##.##.####",
	      "#....##.##....##.##.##.##....#",
	      "#.##.########.##############.#",
	      "#.##.########.##############.#",
	      "#.##.##...................##.#",
	      "#.##.##.##.#####.########.##.#",
	      "#.##.##.##.#####.########.##.#",
	      "#.##.##.##.##..........##.##.#",
	      "#.##.#####.##.##.########.##.#",
	      "#.##.#####.##.##.########.##.#",
	      "#.##....##.##.##.......##.##.#",
	      "#.##.##.#####.##.########.##.#",
	      "#.##.##.#####.##.########.##.#",
	      "#.##.##....##.##.......##.##.#",
	      "#.##.#####.##.#####.##.##.####",
	      "#.##.#####.##.#####.##.##.####",
	      "#.##....##.##....##.##.##....#",
	      "#.##.##.########.##.##.##.##.#",
	      "#.##.##.########.##.##.##.##.#",
	      "#.##.##.......##....##.##.##.#",
	      "#.##.##.#####.#####.########.#",
	      "#.##.##.#####.#####.########.#",
	      "#.##.##....##.##..........##.#",
	      "####.########.########.##.##.#",
	      "####.########.########.##.##.#",
	      "#.......##..........##.##.##.#",
	      "######################.#######"
    ],
    "startRow": 1,
    "startCol": 0
}
